1111111111111111111111111111111111111111111
10P00000000000CCCC0000000C0CC000000000C0001
10000000000000CCCC0000000C0CC000000000C0001
10000000000000CCCC0000000C0CC000000000C0001
10000000000000CCCC0000000C0CC00000E000C0001
1111111111111111111111111111111111111111111